6 15
S...C.....H.H..
..P..C..S..H..H
...P..C......H.
....P..C.DD...H
H.H..P.........
.H....P..CCCC.S
