6 13
..DD...H.H..H
.P......H..H.
..P...C.....H
H..P...C.....
.H..P...C..D.
H....P...C.D.
