14 18
.CCCC....H.H..H...
..........H..H...P
.P.....DD.....H..P
..P..C......D....P
H..P..C...D..D.S.P
.H..P..C..D......P
H....P..C...CCCC..
..S.......C.......
.........C..S.H.H.
.PPPPP..C......H..
.......C..D......S
....D....D...DD...
.H..D..D..........
H.H...D..S..PPPPP.
